20
9
21 2 0 0 0 0 0 0 0 0 0 0 0 0 0 0 0 0 1 21 
22 4 0 0 0 0 0 0 0 0 0 0 0 0 0 0 0 0 3 22 
22 4 0 0 0 0 0 0 0 0 0 0 0 0 0 0 0 0 3 22 
22 4 0 0 0 0 0 0 0 0 9 0 0 0 0 0 0 0 3 22 
22 4 0 0 0 0 0 0 23 24 24 25 0 0 0 0 0 0 3 22 
22 4 0 0 0 10 0 0 0 0 0 0 0 0 0 11 0 0 3 22 
22 4 0 0 23 24 25 0 0 0 0 0 0 23 24 25 0 0 3 22 
22 4 0 9 0 0 0 0 0 0 11 0 0 0 0 0 10 0 3 22 
5 21 21 21 21 21 21 21 21 21 21 21 21 21 21 21 21 21 21 6 
